capture the screen	o o o
zara mere mobile ki screen ka ek screenshot lena	o o o o o o o o o
ek snapshot lo mere cellphone screen ka	o o o o o o o
screenshot to lo zara	o o o o
kripaya ye screen ka chitra save kijiye	o o o o o o o
please ek screenshot le lo	o o o o o
mera ek screen ka shot liyo zara	o o o o o o o
fatafat ek screenshot lo	o o o o
please take screenshot mere phone ke display ka	o o o o o o o o
kia screenshot ke sakte hain please	o o o o o o
snapshot lo mere phone ki screen ka	o o o o o o o
screenshot save karo	o o o
take a screenshot	o o o
kya mere phone ki screen ka ek screenshot le sakte ho?	o o o o o o o o o o o
kya mere phone ke display ka picture le sakte ho?	o o o o o o o o o o
kya tum mere phone ki screen ka pic ke sakte ho?	o o o o o o o o o o o
screenshot khichne k baad save kijiye please	o o o o o o o
kia ek screenshot le sakte hain	o o o o o o
jaldi se ye wali screen ka ek chitra lijiye aur gallery mein save karien	o o o o o o o o o o o o o o
please ek scren shot le ke do	o o o o o o o
screenshot lo aur picture save karoscreen ko capture karo	o o o o o o o o o
is page ka screenshot le lo	o o o o o o
jaldi se ye screen ko picture mein save karo	o o o o o o o o o
screen ka shot lena	o o o o
mujhe is page ka screenshot chahiye	o o o o o o
screenshot kheencho	o o
jaldi se screen shot lo	o o o o o
is webpage ka ek screenshot lo	o o o o o o
ye wali screen ko capture kar lo	o o o o o o o
kia app ye screenshot le sakte hain	o o o o o o o
is screen ki photo khheencho	o o o o o
screen ka ek snapshot le	o o o o o
jaldi se screenshot le mere phone ka	o o o o o o o
please mobile phone pe jo displayed hai uska screenshot lo	o o o o o o o o o o
ye wali sreen ka chitra save karo	o o o o o o o
koi screenshot lijiye please	o o o o
kripaya ek screenshot le lijiye	o o o o o
jaldi se mere cellphone screen ka ek snapshot lo	o o o o o o o o o
screen ki photo lo	o o o o
mujhe ye screenshot baad ke liye chahiye	o o o o o o o
is screen page ki photo click kar	o o o o o o o
screenshot save kijiye please	o o o o
ek screenshot le lijiye	o o o o
screen ki picture nikalo	o o o o
jaldi se ye screenshot ko capture karien	o o o o o o o
kya tum mere liye ek screenshot le sakte ho?	o o o o o o o o o
if possible mere phone ki screen ka ek screen shot lekar rakho	o o o o o o o o o o o o
please screenshot le ljiye	o o o o
please ye wali screen ki chitra lp	o o o o o o o
kya mere cellphone se ek screenshot liya ja sakta hai?	o o o o o o o o o o
zara mere cell ki screen ka ek shot le lo	o o o o o o o o o o
ye waali screen ki photo kheencho	o o o o o o
iska screenshot lekar save karo	o o o o o
iska screenshot lo please	o o o o
please ek snapshot le lo screen ka	o o o o o o o
mujhe screenshot lena hai	o o o o
screenshot le lo na of my phone's screen	o o o o o o o o
ye jo screen hai iski tasviir save karo	o o o o o o o o
kripaya ye screen ka chitra ko gallery mein save kijiye	o o o o o o o o o o
get a screen shot of this mere phone pe	o o o o o o o o o
screenshot ko gallery mein save karo	o o o o o o
ek shot liyo zara screen ka	o o o o o o
ise screenshot ki tarah save karo	o o o o o o
snap le ke do mere cellphone display ka	o o o o o o o o
mere phone ke display ka screen shot le kar rakho	o o o o o o o o o o
screen picture kicho	o o o
please mere phone ki screen ka ek shot le lo	o o o o o o o o o o
screen ki picture khincho	o o o o
please tum ek snapshot le lo na	o o o o o o o
turant mere cellphone ka ek screenshot lekar dikhao	o o o o o o o o
iska screenshot kheencho	o o o
screen picture ko save karo	o o o o o
ek screenshot lo zara	o o o o
is screen ki photo lena zara	o o o o o o
fatafat ek screenshot lo is picture ka	o o o o o o o
please mere mobile ki screen ka ek shot lo	o o o o o o o o o
please screenshot capture kijiye	o o o o
ek screenshot to lo	o o o o
please screen pe jo hai uska shot le lo	o o o o o o o o o
jaldi screen shot khicho	o o o o
please screenshot capture karo	o o o o
please ye screenshot ko save kijiye	o o o o o o
help me take a screenshot mere phone ka	o o o o o o o o
mere phone ke screen ko capture karo	o o o o o o o
phone ka ek screen shot le lo	o o o o o o o
screenshot khicho	o o
screenshot le lo	o o o
is screen ka ek shot lekar do	o o o o o o o
please mere phone ki screen ka ek snap lo	o o o o o o o o o
screen ka snapshot lo	o o o o
capture mere mobile phone ka screen	o o o o o o