saare messages jo puja se aaye hain unhe padho	B_Feature/Action o o B_Contact_Name o o o o o
meri tailor ka koi new message aaya hai padho to	B_Contact_Name I_Contact_Name o o B_Feature/Action o o o o o
koi naya message aya ho to read karo	o o o o o o o o
nazima  ka aakhiri message padho jismein ye shabd ho shopping	B_Contact_Name o B_Feature/Action o o o o o o B_Catchall_Phrase
padh kar sunao agar koi unread message aaya hua hai	o o o o o B_Feature/Action o o o o
mujhe maa se aaye hue messages read karke sunao	o B_Relation o o o o o o o
kya tum mujhe angad ka last message jismein usne likha hai party is on padh doge	o o o B_Contact_Name o B_Feature/Action o o o o o B_Catchall_Phrase o o o o
last month ke saare kabir singh se aaye messages read karein	B_Month I_Month o o B_Contact_Name I_Contact_Name o o o o o
tum mere liye puja ka last message padhoge	o o o B_Contact_Name o B_Feature/Action o o
first wala message padhke sunao	o o o o o
mujhe new messages padh kar sunao	o B_Feature/Action o o o o
ankur ko bheja hua mera last message padho to	B_Contact_Name o o o o B_Feature/Action o o o
meri best friend ka dusra wala message abhi padho	B_Relation I_Relation I_Relation o B_Feature/Action I_Feature/Action I_Feature/Action o o
woh messages dikhao jismein there is meeting in it	o o o o o o B_Catchall_Phrase o o
can you please read out the last message	o o o o o o B_Feature/Action o
mausa ji ka unread message padhna	B_Relation I_Relation o B_Feature/Action o o
firki ka last wala message padh ke suna	B_Contact_Name o B_Feature/Action I_Feature/Action o o o o
printer service waalon ka latest message padhiye zara	B_Contact_Name I_Contact_Name o o B_Feature/Action o o o
mujhe zoya ka woh message padh do jismein likha hai get coffee	o B_Contact_Name o o o o o o o o B_Catchall_Phrase I_Catchall_Phrase
koi naya text  message to padh do please	o B_Feature/Action o o o o o o
please read out unread message	o o o B_Feature/Action o
meri maa se aaye messages read kar de	B_Relation I_Relation o o o o o o
jaldi se message padhke sunao jo abhi aya hai	o o o o o o B_Feature/Action I_Feature/Action I_Feature/Action
puja se koi naya sandesa aaya hai to padh dijiye	B_Contact_Name o o o o o o o o o
bipin da ke recent messages ko padho	B_Contact_Name I_Contact_Name o B_Feature/Action o o o
dopahar se aaye unread messages sunao	B_Time o o B_Feature/Action o o
friends group ke aaj ke messages padh kar sunao	B_Contact_Name B_Message_Type o B_Day I_Day o o o o
all messages from aditi unhe padho	B_Feature/Action o o B_Contact_Name o o
agar koi new message receive kia hai to padh do	o o B_Feature/Action I_Feature/Action I_Feature/Action o o o o o
jo sabse last message aaya hai from pooja use padho	o B_Feature/Action I_Feature/Action o o o o B_Contact_Name o o
wo messages padho jismein hello shabd hai	o o o o B_Catchall_Phrase o o
mere ko new wale messages padh kar sunaiye	o o B_Feature/Action I_Feature/Action o o o o
please naya message padhke sunao	o B_Feature/Action o o o
hari ke ghar wale phone se haal hi mein aaye hue message ko padh	B_Contact_Name o B_Location I_Location I_Location o o o o o o o o o
angad ke satellite phone se haal hi mein aaye hue messages ko padhiye	B_Contact_Name o B_Number_Type I_Number_Type o B_Feature/Action I_Feature/Action I_Feature/Action I_Feature/Action I_Feature/Action o o o
any new message to padh do	o B_Feature/Action o o o o
sabse latest wala text message padho	B_Feature/Action I_Feature/Action I_Feature/Action o o o
please mera latest received message padho zara	o o B_Feature/Action I_Feature/Action o o o
mujhe amit ka latest text padh kar sunao	o B_Contact_Name o B_Feature/Action o o o o
weekend mein aaye hue nanu ke sms read karo	B_Day o o o B_Relation o o o o
yash ke mobile phone se aaya latest message padh do please	B_Contact_Name o B_Number_Type I_Number_Type o B_Feature/Action I_Feature/Action o o o o
puja ne apne last message mein kya kaha hai	B_Contact_Name o o B_Feature/Action o o o o o
bhabhi se aaya hua lovely message read kar do phir se	B_Relation o o o o o o o o o o
mujhe bhavna se aaya latest sms sunao	o B_Contact_Name o o B_Feature/Action o o
latest message jo aya hai usko read karo	B_Feature/Action I_Feature/Action I_Feature/Action I_Feature/Action o o o o
mere mobile number pe recently aya hua message khol ke padho	o B_Number_Type o o B_Feature/Action I_Feature/Action I_Feature/Action o o o o
woh sab messages show karo jo onkar se aaye hain	o o o o o o B_Contact_Name o o o
padh kar sunao if there is some unread message	o o o o o o o B_Feature/Action o
un messages ko padho which has the word meeting in it	o o o o o o o o B_Catchall_Phrase o o
tum mere liye aalia ka lastest message padh do	o o o B_Contact_Name o o o o o
shanti bua ka message aya ho to read it now	B_Contact_Name B_Relation o o B_Feature/Action I_Feature/Action o o o o
mukesh ka message padh kar sunao	B_Contact_Name o o o o o
mujhe bhai ka aaj ka message sunana hai	o B_Relation o B_Day I_Day o o o
agar koi naya message aaya hai to read karo please	o o B_Feature/Action o o o o o o o
last message padho	B_Feature/Action o o
jo message abhi send kia hai read karo	o o B_Feature/Action I_Feature/Action I_Feature/Action I_Feature/Action o o
mera bheja hua last message padho to	o o o B_Feature/Action o o o
sunaiye zara kya kya messages aaye hai phone par	o o o o o o o o o
pichhle weekend ke messages padh do	B_Day I_Day o o o o
family group per aaye aaj ke unread message sunao please	B_Contact_Name B_Message_Type o o o o B_Feature/Action o o o
unread messages sunaiye	B_Feature/Action o o
unread messages padho	B_Feature/Action o o
jinmein credit card numbers aate hain wo saare messages samne lao	o B_Catchall_Phrase I_Catchall_Phrase I_Catchall_Phrase o o o o o o o
show me messages jismein bank word ho	o o o o B_Catchall_Phrase o o
message padho	o o
message padhna zara	o o o
latest messages jo aaye hain padhiye to	B_Feature/Action o o o o o o
sheetal se aya hua message read kariye	B_Contact_Name o B_Feature/Action I_Feature/Action o o o
messages jo puja krishnan ke work number se aaye hain padh do	o o B_Contact_Name I_Contact_Name o B_Location I_Location o o o o o
mujhe wo messages read karo jinmein birthday ka mention ho	o o o o o o B_Catchall_Phrase o o o
read out the last message	o o o B_Feature/Action o
jitne bhi unread messages hain unhe padhiye	o o B_Feature/Action o o o o
read out loud wo messsages jisme fun word ho	o o o o o o B_Catchall_Phrase o o
sabhi new wale messages jo aye hai read them	o o o o o o o o o
abhi last wali text message padho	o B_Feature/Action I_Feature/Action o o o
bhavesh ji se jitne bhi new messages aaye hain unhe padho	B_Contact_Name I_Contact_Name o o o B_Feature/Action o o o o o
message pratham books company walon read karein	o B_Contact_Name I_Contact_Name I_Contact_Name o o o
aditi se aaye hue all messages parh daalo	B_Contact_Name o o o B_Feature/Action o o o
jasleen ke liye mera message mujhe sunao	B_Contact_Name o o o o o o
jinmein work credit aata hai wo saare messages padho	o B_Catchall_Phrase I_Catchall_Phrase o o o o o o
kya papa se received all messages padh ke suna sakte ho?	o B_Relation o B_Feature/Action I_Feature/Action o o o o o o
hdfc bank ke sare messages read karo	B_Contact_Name o o o o o o
last unread message ko padhke sunao	B_Feature/Action I_Feature/Action o o o o
bhajan mandali group ke previous messages sunaein	B_Contact_Name I_Contact_Name B_Message_Type o B_Feature/Action o o
10 tarikh ko aaya citibank walon ka message read kariye	B_Date I_Date o o B_Contact_Name o o o o o
mere bank ka sandesh padhke sunao	o B_Contact_Name o o o o
abhi abhi ek new text message aaya hai use padho	o o o B_Feature/Action o o o o o o
mera last message padhkar sunao	o B_Feature/Action o o o
saare new wale messages sunao	o B_Feature/Action I_Feature/Action o o
sms jo meri bahen ne send kiye hain read karo	o o B_Relation I_Relation o o o o o o
next message padhke sunao	B_Feature/Action o o o
kritika ka last text message padh kar sunao	B_Contact_Name o B_Feature/Action o o o o o
mujhe new messages sunane hain	o B_Feature/Action o o o
kia akhri message padhke sounaoge	o B_Feature/Action o o o
deepak se aaya latest message sunao	B_Contact_Name o o B_Feature/Action o o
ek ek karke mere unread message sunao	o o o o B_Feature/Action o o
meher ji ka latest message padhna	B_Contact_Name I_Contact_Name o B_Feature/Action o o
indrani se koi new message aaya hai to padh dein	B_Contact_Name o o B_Feature/Action o o o o o o
maine jo aakhir wala message bheja hai read it	o o B_Feature/Action I_Feature/Action o o o o o
jo abhi text message aaya hai use padho	o B_Feature/Action o o o o o o
jitne bhi new messages hain unhe padho	o o B_Feature/Action o o o o
mujhe zoya ka woh message padh do jismein likha hai interview	o B_Contact_Name o o o o o o o o B_Catchall_Phrase
nykaa cosmetics ka koi message aya ho to read that	B_Contact_Name I_Contact_Name o o o o o o o o
canara bank ka last received message padh ke sunao	B_Contact_Name I_Contact_Name o B_Feature/Action I_Feature/Action o o o o
oriental bank insurance se aaye hue text messages padh ke sunao	B_Contact_Name I_Contact_Name I_Contact_Name o B_Feature/Action I_Feature/Action o o o o o
meri saasuma se aaya latest message sunao	o o o o B_Feature/Action o o
amrutesh ka last text message padho zara	B_Contact_Name o B_Feature/Action o o o o
read again wo last wala message	o o o o o o
pooja ka last message read karo	B_Contact_Name o B_Feature/Action o o o
last evening se aaye messages ko sunaiye	B_Day I_Day o o o o o
text jo rajiv aggarwal ke office number se aaye hain padh do	o o B_Contact_Name I_Contact_Name o o o o o o o o
revati ke messages wo wale nikal kar dikhao jismein amazon word ho	B_Contact_Name o o o o o o o o B_Catchall_Phrase o o
unread text message padho	B_Feature/Action o o o
last sent message padh ke sunao	B_Feature/Action I_Feature/Action o o o o
all the messages jo junaid se aaye hain unhe padho zara	o o o o B_Contact_Name o o o o o o
raghav uncle ka aya hua message sunao abhi	B_Contact_Name B_Relation o o o o o o
latest wala text message padh do	B_Feature/Action I_Feature/Action o o o o
puja se jo last message aaya hai use padh do	B_Contact_Name o o B_Feature/Action o o o o o o
kritika ka akhiri text message padh kar sunao	B_Contact_Name o B_Feature/Action o o o o o
pratap ke akhiri message dhundo jismein likha hai shopping	B_Contact_Name o B_Feature/Action o o o o o B_Catchall_Phrase
who wale messages read out karo jiske text mein debit word ho	o o o o o o o o o B_Catchall_Phrase o o
woh messages saamne lao jiske text mein meeting word ho	o o o o o o o B_Catchall_Phrase o o
citibank se aaye hue text messages dikhao	B_Contact_Name o o o o o o
last evening se koi naya message aaya hai to padhiye	B_Day I_Day o o B_Feature/Action o o o o o
right now jo text message mila use padh kar sunao	B_Feature/Action I_Feature/Action I_Feature/Action o o o o o o o
akhri message padhke sunao	B_Feature/Action o o o
jo abhi text message mila use padh kar sunao	o B_Feature/Action o o o o o o o
please read last unread message	o o B_Feature/Action I_Feature/Action o
padh kar sunao agar koi unread message pada hua hai to	o o o o o B_Feature/Action o o o o o
kya tarun se aaya hua last message padhoge	o B_Contact_Name o o o B_Feature/Action o o
saare new messages padhiye	o B_Feature/Action o o
sabhi unread messages ko padh do	B_Feature/Action I_Feature/Action o o o o
mujhe ammi ke friday ke messages read karke sunao	o B_Relation o B_Day o o o o o
maine jo last wala message bheja hai please read that	o o B_Feature/Action I_Feature/Action I_Feature/Action I_Feature/Action I_Feature/Action o o o
palak ka latest message padhiye	B_Contact_Name o B_Feature/Action o o
phufaji ka text message read out aloud	B_Relation o o o o o o
aap padh kar sunao ki puja ne apne last message mein kya likha hai	o o o o o B_Contact_Name o o B_Feature/Action o o o o o
meri friend sulekha se aaye hue messages read karke sunao	B_Relation I_Relation B_Contact_Name o B_Feature/Action I_Feature/Action o o o o
meri naatin ki sandeshon mein se last wala read kar do	B_Relation I_Relation o o o o B_Feature/Action o o o o
tum parvez ka last message padh kar sunao mujhe	o B_Contact_Name o B_Feature/Action o o o o o
please subah aya hua message padhke sunao	o B_Time B_Feature/Action I_Feature/Action o o o
please shashi ka last message jo aya hai read it	o B_Contact_Name o o o o o o o o
agar koi naya message aaya hai to padh do	o o B_Feature/Action o o o o o o
mere ko unread messages sunane hai	o o B_Feature/Action o o o
unread messages ko padho	B_Feature/Action o o o
mera aakhiri wala message padh kar suna do	o B_Feature/Action I_Feature/Action o o o o o
saare naye wale messages padh ke sunao please	B_Feature/Action I_Feature/Action I_Feature/Action o o o o o
meri ammi ne message bheja hoga padho zara	B_Relation I_Relation o o B_Feature/Action I_Feature/Action o o
angad ka akhiri message padho jismein likha hai hello	B_Contact_Name o B_Feature/Action o o o o o B_Catchall_Phrase
kaavya ke latest message mein kya likha hai read it	B_Contact_Name o B_Feature/Action o o o o o o o
read out loud the message from phupha ji	o o o o o o B_Relation I_Relation
all unread messages ko padhiye	o B_Feature/Action o o o
angad se aaye hue sandeshon mein se last wala padh do	B_Contact_Name o o o o o o B_Feature/Action I_Feature/Action o o
jo sabse last wala message aaya hai from manish use padhiye	o B_Feature/Action I_Feature/Action I_Feature/Action I_Feature/Action I_Feature/Action I_Feature/Action o B_Contact_Name o o
sabhi naye wale messages read karo	o B_Feature/Action I_Feature/Action o o o
last unread message padho	B_Feature/Action I_Feature/Action o o
sunein to kya new messages aaye hai phone par	o o o B_Feature/Action o o o o o
jo naya message aya hai read it	o B_Feature/Action o o o o o
kya tum all new messages padhoge	o o o B_Feature/Action o o
amit ke text messages mein se ese nikalo jinmein hdfc ke baare mein baat ki gayi hai	B_Contact_Name o o o o o o o o B_Catchall_Phrase o o o o o o o
wo sabhi sandesh dikhayein jismein happy diwali shabd hon	o o o o o B_Catchall_Phrase I_Catchall_Phrase o o
messages jo unread hain unhe padhiye please	o o B_Feature/Action o o o o
tu aarav ka new message padh kar mujhe suna	o B_Contact_Name o B_Feature/Action o o o o o
mujhe shashi ka last message sunana hai read it	o B_Contact_Name o B_Feature/Action o o o o o
read karo wo wala message jo maine latest bheja hai	o o o o o o o B_Feature/Action I_Feature/Action I_Feature/Action
mujhe those messages read karo jismein adarsh ka naamaaya hai	o o o o o o B_Catchall_Phrase o o o